
         NO      ./img/a1.xpm    
SO     ./img/a2.xpm

 F    49, 79, 49
        C    101, 133, 161 

        WE      ./img/a3.xpm


EA   ./img/a4.xpm



        1111111111111111111111111 
        1000000000110000000000001
        1011000001110000000000001
        1001000000000000000000001
111111111011000001110000000000001
100000000011000001110111111111111
11110111111111011100000010001
11110111111111011101010010001
11000000110101011100000010001
100000000000000011001N0010001
1000000000000001101011010001
110000011101010111110111100111
11110111 1110101 101111010001
11111111 1111111 111111111111

